30,15
        ***********
  *     *          **      
    *   *       *                
    *   *       *
***
         ******** *********************
***
   *****   ******* **
***     **    *
**      *
*********** *******   ** **
*** ** * *
       * *
       * *******          *
       *      **  *
       *      ** *
       *        *    *
                   *  *
********************************

                          
                          





